XXXXXXXXXXXXXXXXXXXXXXXXXXXXXXXXXXXXXXXXXXXXXXXXXXXXXXXXXXXXXXXXXXXXXXXXXXXXXXXXXXXXXXXXXXXXXXXXXXXXX
P   X   X                   X           X     X   X   X   X       X                   X     X       X
X X XXX X XXX XXXXX XXXXXXXXX XXXXXXXXX X XXX X X X X X X X XXXXX X XXXXXXXXXXXXXXXXX X XXX XXXXX X X
X X     X   X X   X X       X X       X     X   X X X   X   X X   X   X X   X       X X   X   X   X X
X XXXXXXXXX X X X XXX XXXXX X X XXX X XXXXXXXXXXX X XXXXXXXXX X XXXXX X X X X XXXXX X X X XXX X XXXXX
X   X     X X   X   X X   X   X X   X   X X       X     X     X         X X X X   X   X X X   X     X
XXX X X XXX XXXXXXX X X X XXXXXXX XXXXX X X XXXXXXXXXXX X XXX XXXXXXXXXXX X X X XXXXXXXXX X XXXXXXX X
X   X X   X X     X X X X       X X   X X X   X       X   X X X   X       X   X     X     X   X   X X
X XXX XXX X X XXX X X X X XXXXX X XXX X X XXX X XXXXX XXXXX X XXX X XXXXXXXXXXXXXXX X X XXXXX X X X X
X X   X X   X X   X   X X X X   X   X X X   X X X X         X X   X X       X       X X   X     X   X
X X XXX XXXXXXX X XXXXXXX X X XXXXX X X X X X X X X XXXXXXX X X XXX X XXXXX X X XXXXX XXX X XXXXXXXXX
X   X           X X       X X       X   X X X     X   X     X X     X     X X X     X X   X X       X
X XXXXX XXXXXXXXX XXX XXXXX XXX XXXXXXX XXX XXXXXXXXX X XXXXX XXXXXXXXXXX XXX XXXXX X X XXXXX XXXXX X
X X     X X     X     X   X     X     X     X     X   X X   X X         X         X   X     X     X X
X X XXXXX X XXX XXXXXXX XXX XXXXX XXX XXXXXXX XXX X XXX X X X XXX XXXXX XXXXXXX XXXXXXXXX X XXX XXX X
X X X   X     X X     X   X X     X X       X X X   X X   X X   X X   X     X   X       X X X   X   X
X X XXX X XXXXX X XXX X X X X XXXXX XXXXXXX X X XXXXX XXX XXXXX X X X XXXXX XXXXX XXXXX X X X XXX X X
X   X   X X     X   X   X X X X     X         X         X X     X   X X   X X   X X   X X X X   X X X
XXXXX X X X XXXXXXX XXXXX X X X XXX X XXXXXXXXXXXXXXX XXX X XXXXX XXX X XXX X X X X X X XXX X XXX X X
X X   X X X     X   X   X   X X   X X   X   X   X   X X   X X   X   X X     X X   X X   X   X X   X X
X X X X X XXXXX X XXXXX XXXXX XXX X XXX X X X X X X X X XXX XXX X XXX X XXXXX XXXXX XXXXX XXX X XXX X
X X X X X X   X X X     X X   X   X   X X X   X   X X   X X   X   X   X X     X     X X       X X   X
X X X XXX X X X X X X X X X XXXXX X XXX X XXXXXXXXX X XXX XXX XXXXX XXX X XXXXX XXXXX X XXXXXXX X XXX
X X X   X   X X X X X X X X     X X     X   X     X X   X X   X     X X X   X X X     X X   X   X   X
X X XXX XXX XXX X X X X X XXXXX X XXXXXXXXX X XXX X XXX X X XXX XXXXX X XXX X X XXXXX X XXX X XXXXX X
X X X   X   X   X X X X     X   X X     X   X   X X X     X X   X     X     X X     X     X X X   X X
X X X X X XXX X X XXX XXXXXXX X XXX XXX X XXXXX XXX XXXXX X XXX X XXX XXXXXXX XXXXX XXXXX X X X XXX X
X   X X X X X X X   X   X     X X   X X   X   X   X   X X X   X X X X   X       X X   X     X X     X
X XXX XXX X X X XXX X X X XXXXXXX XXX XXXXX X XXX XXX X X XXX X X X X XXX XXX X X XXX XXXXXXX X XXXXX
X X X       X X   X X X X         X   X     X X     X X   X X   X X X       X X X   X         X X   X
X X XXXXXXXXX XXXXX XXX XXXXXXXXXXX X X XXXXX X X XXX X XXX XXXXX X XXXXXXXXX X X X XXXXXXXXXXX XXX X
X X     X     X     X   X     X   X X X     X   X X   X X     X   X   X   X   X   X X   X     X X   X
X X XXX X XXX X XXXXX X XXX X X X X X XXXXX XXXXXXX XXX X XXXXX XXX XXX X X XXXXXXX X X X X X X X X X
X   X X X X   X X     X X   X   X   X   X   X   X   X     X   X X   X   X X       X X X   X X X X X X
XXXXX X X X XXX XXXXX X X XXXXXXXXXXXXX X XXX X X XXXXX XXX X X X XXX XXX XXXXXXX X X XXXXX X X X X X
X     X X X   X       X X         X     X     X X X   X X   X   X     X   X     X X X   X   X X   X X
XXXXX X X X XXXXXXXXXXX X XXXXXXX XXXXX XXXXXXX X X X XXX XXXXXXXXXXXXX X X XXX X XXXXX X XXXXXXXXX X
X     X X X X         X X X     X     X         X X X   X X         X   X   X   X       X         X X
X XXXXX X XXX X XXX XXX X XXX X XXXXX XXXXX XXXXX X XXX X X XXX XXX X XXXXXXX XXXXXXXXXXXXXXXXXXX X X
X       X     X   X X   X     X     X X     X     X   X   X   X   X X X   X   X             X   X   X
X XXXXXXXXXXXXXXX XXX XXXXXXXXXXXXX X X XXXXX XXX XXX XXXXXXXXXXX X X X XXX XXX XXX XXXXXXX XXX XXXXX
X   X     X     X     X X       X   X X X   X   X   X     X       X X X   X X     X     X       X   X
XXX XXX X X XXX XXXXXXX X XXX X X XXX XXX X XXX XXX XXXXX X XXXXXXX X XXX X XXXXXXXXXXX XXXXXXX X X X
X X X   X X   X   X   X   X   X X   X X   X   X   X     X   X     X   X   X X     X   X X     X   X X
X X X XXX XXXXX XXX X X XXX XXX XXX X X XXX XXXXX XXXXXXXXXXXXX XXXXXXX XXX X XXX X X X X XXX XXXXXXX
X   X X         X   X   X X X   X X X   X X     X X   X         X         X X X   X X X     X   X   X
X XXX XXXXXXXXX X XXXXXXX X XXX X X XXXXX XXX X X X X X X XXXXX X XXXXXXX X X X XXX X X XXXXXXX X X X
X X X   X   X   X X       X   X   X X       X X X   X   X X   X X     X   X   X X   X X X     X   X X
X X X X XXX X XXX XXX XXXXXXX XXXXX X X XXXXX X XXXXXXXXX X X XXXXXXX X X XXXXX X X X X X XXX XXXXX X
X X   X   X X   X   X       X     X X X     X X     X   X X X     X   X X     X X X X X X X   X   X X
X XXX XXX X X XXXXX XXX XXX XXXXX X XXXXXXX X XXXXX XXX X X XXXXX X XXX XXXXX X XXX X X X XXX X X X X
X   X X   X   X   X   X   X     X X X     X X   X       X   X   X X   X     X X X   X X X   X   X   X
XXX X X XXX XXX X XXX XXXXX XXXXX X X XXX X XXX XXXXXXXXXXXXX X X XXX XXXXX XXX X XXX XXXXX XXXXXXX X
X X X X X     X X   X X     X     X   X X X   X       X       X X     X   X X   X X X     X X   X   X
X X X X XXXXX X XXX X X XXX X XXXXXXXXX X X X XXXXXXX X XXX XXX XXXXXXX X X X XXX X XXXXX X XXX X XXX
X X X X     X X X X     X   X           X X X       X     X   X X   X   X X X     X X     X   X X   X
X X X XXXXX XXX X XXXXXXXXXXXXX XXXXXXX X X XXXXXXX XXXXXXXXX X XXX X X X X XXXXXXX X XXXXXXX X XXX X
X   X     X X   X X           X       X   X X     X   X     X X     X X X X     X     X       X     X
X XXX XXXXX X XXX X XXXXXXXXX XXXXXXX XXXXXXX XXX X XXX XXX X XXXXX X X X X XXXXX XXXXXXX XXXXXXXXX X
X X   X   X       X X X     X   X   X X       X X X   X   X X   X X X X X X     X X     X     X   X X
X XXX X X X XXXXXXX X X X XXXXX X X X XXXXX XXX X XXX XXX X XXX X X X X X XXXXX X X XXX X XXX X X X X
X   X X X X   X     X   X X     X X X       X   X     X X X     X   X X X X     X   X X X   X   X X X
XXX XXX X XXX X XXXXX XXX X XXXXX XXXXXXXXXXX XXXXXXX X X XXXXX XXXXX X XXX XXX XXXXX X XXXXXXXXX X X
X   X   X   X X X   X   X   X X               X       X X     X X     X   X X         X           X X
X XXX XXXXX XXX X X XXX XXXXX X XXXXXXX X XXXXX XXXXXXX XXXXX XXX XXXXXXX X XXXXXXXXX XXXXXXXXXXXXX X
X   X X       X X X   X X         X   X X     X X       X   X X   X     X X X     X   X X         X X
XXX X XXXXXXX X X X X X XXX XXXXXXX X XXXXXXX X XXX XXX X XXX X XXX X XXX X X XXX XXX X X X XXXXX X X
X   X   X   X   X X X X   X     X   X X     X       X   X X   X   X X X   X   X X   X   X X   X X X X
X XXX X X X XXXXX X XXXXX XXXXXXX XXX X XXX XXXXXXXXX XXX X XXXXX X X X XXXXXXX XXX XXXXX XXX X X X X
X X   X   X   X X X       X       X X   X       X   X     X   X   X X X     X   X   X     X X X   X X
X X XXXXXXXXX X X XXXXXXXXX X XXXXX X XXXXXXXXX X X XXXXX XXX X XXXXX XXX X XXX X XXX XXXXX X X XXX X
X X X       X X X         X X X   X X X     X X X X       X   X         X X     X     X   X X X X   X
X XXX XXXXX X X XXXXXXXXX X XXX X X X X XXX X X XXXXX XXXXX XXXXXXXXXXX X XXXXX XXXXXXX X X X XXX XXX
X   X   X     X   X       X X   X X X X X   X X     X X   X           X X   X X   X     X   X X   X X
XXX XXX XXXXXXX X X XXXXXXX X XXX X X X X XXX XXXXX X X XXXXX XXXXXXX X XXX X XXX X XXX XXX X X XXX X
X X   X X     X X     X         X X   X X X   X     X   X   X     X X     X X X   X X   X X X   X   X
X XXX X X XXX XXXXXXX XXX XXXXXXX XXXXX X X XXX XXXXXXXXX X XXXXX X XXXXXXX X X XXXXX XXX X XXXXX XXX
X X   X     X     X X   X X     X     X X X     X         X     X     X X   X         X   X   X     X
X X XXXXXXXXXXXXX X XXX X X XXX X XXX X X XXX XXX XXXXXXXXXXXXX XXXXX X X X XXXXXXXXXXX XXXXX XXXXX X
X X X   X     X   X X   X X X X X   X   X   X X X   X X       X   X     X X X   X     X     X     X X
X X X X X XXX X XXX X XXXXX X X XXXXXXXXXXX X X X X X X X XXX XXX XXXXX X XXX X X XXX XXX XXXXXXX X X
X X   X X X     X   X X     X X       X   X X X   X X   X   X   X   X   X     X X X       X     X X X
X XXXXX X XXX XXXXX X X XXXXX XXXXXXX X X X X XXX X X XXXXX XXXXXXX X XXXXXXXXX X XXXXXXXXX XXX X X X
X   X   X   X X   X X   X     X     X   X X X   X X X   X   X       X X       X X X   X     X   X X X
X X X XXX X XXX X X XXXXX X X X X XXXXXXX X XXX X X XXX X XXX XXXXXXX X XXXXX X X X X X XXXXX XXX X X
X X   X   X     X X   X   X X X X       X   X   X X   X X     X       X X     X X X X X   X X   X X X
X XXXXXXXXXXX XXX X X X XXX XXX XXXXXXX XXXXX XXX XXX X XXXXXXXXXXX XXX X XXX X X X X XXX X XXX X X X
X           X X   X X X   X   X   X   X   X   X   X   X   X       X X   X   X X X   X     X X   X   X
XXXXXXXXXXX X X XXX X XXX XXX XXX X XXX X X XXXXX X XXXXX X XXXXX X XXXXXXX X X X XXXXXXXXX X XXXXX X
X       X   X X X   X   X   X   X   X   X X     X X   X X X X X   X     X   X X X   X X     X       X
X XXXXXXX XXXXX X XXX XXX XXXXX XXX X XXXXXXXXX XXX X X X X X X XXXXXXX X X XXX XXX X X X X XXXXXXXXX
X X     X X     X   X     X       X X         X   X X X X X X   X     X X X X   X X X   X X X     X X
X X XXX X X XXXXXXX XXXXXXX XXXXX X XXXXXXXXX XXX XXX X X X X XXX XXX X X XXX XXX X XXXXX X X XXX X X
X X   X X X       X   X   X   X   X     X     X   X   X   X X     X   X   X   X   X   X   X X X   X X
X X XXX X X XXXXX XXX X X XXX X XXXXXXX X XXX X XXX XXX XXX XXXXXXX XXXXXXX XXX XXXXX X XXX X X XXX X
X X X   X X     X   X X X X   X       X X X   X     X   X       X X         X   X     X   X   X   X X
X X X X X XXXXXXXXX X X XXX XXXXXXX XXX X XXXXXXXXXXX XXXXXXXXX X XXXXXXXXXXXXX X XXXXXXX XXXXXXX X X
X X X X X   X       X X X   X   X   X   X   X   X   X X     X   X X     X       X   X     X     X X X
X X X XXXXX X XXXXXXX X X XXX X XXXXX XXXXX X X X X X X XXX X XXX X X XXX XXX XXXXX X XXXXX XXX X X X
X   X         X         X     X           X   X   X     X     X     X       X         X       X     K
XXXXXXXXXXXXXXXXXXXXXXXXXXXXXXXXXXXXXXXXXXXXXXXXXXXXXXXXXXXXXXXXXXXXXXXXXXXXXXXXXXXXXXXXXXXXXXXXXXXXX